-27
18
-9
13
0000000000000000000000000000000000000000000000
0000000000000000000000000000000000000000000000
0000000000000000000000000000000000000000000000
0000000000000000000000000000000000000000000000
0000000000000000000000000000000000000000000000
0000000000000000000000000000000000000000000000
0000000000000000000000000000000000000000000000
0000000000000000000000000000111111100000000000
0000000000000000000000000000111111100000000000
0000000000000000000000000000111111100000000000
0000000000000000000001000000111111100000000000
0000000000001111111000000000111111100000000000
0000000000001111111000001000111111100000000000
0000000000001111111000000000111111100000000000
0000000000001111111000000000000000000000000000
0000000000001111111000000000000000000000000000
0000000000001111111000000000000000000000000000
0000000000001111111000000000000100000000000000
0000000000000000000000000000000000000000000000
0000000000000000000000000000000000000000000000
0000000000000000000000001000000000000000000000
0000000000000000000000000000000000000000000000
0000000000000000000000000000000000000000000000
